NO textures/simonkraft/wet_sponge.xpm
SO textures/simonkraft/bookshelf.xpm
WE textures/simonkraft/bookshelf.xpm
EA textures/simonkraft/netherrack.xpm

F 98, 120, 66 
C 44,44,84

111111111111111111111
1000000N0000000001001
100000010011111111001
100101010000000000001
100010000000011111111
100000000000011000001
100101100000000000011
111111111111110111111
            100101
            101101
            100001
            111111

